1191 670 900 550
images/bgnd.jpg
resources/tristam.mp3
482 228 1191 670 0 0 0 1
images/rectangle.png
520 228 1191 670 0 0 0 1
images/rectangle.png
556 229 1191 670 0 0 0 1
images/rectangle.png
590 230 1191 670 0 0 0 1
images/rectangle.png
372 205 1191 670 0 0 0 1
images/rectangle.png
284 165 1191 670 0 0 0 1
images/rectangle.png
195 109 1191 670 0 0 0 1
images/rectangle.png
82 43 1191 670 0 0 0 1
images/rectangle.png
10 16 1191 670 0 0 0 1
images/rectangle.png
482 149 1191 670 0 4 1 1
images/coin.png
544 152 1191 670 0 4 1 1
images/coin.png
598 146 1191 670 0 4 1 1
images/coin.png
1027 429 1191 670 0 0 0 1
images/rectangle.png
1067 429 1191 670 0 0 0 1
images/rectangle.png
1106 429 1191 670 0 0 0 1
images/rectangle.png
1032 331 1191 670 0 4 1 1
images/coin.png
1092 329 1191 670 0 4 1 1
images/coin.png
1038 131 1191 670 0 4 3 1
images/grab.png
315 19 1191 670 0 4 3 1
images/grab.png
